#.....#...
##.#......
...#......
..........
...#..#...
......##.#
.#.....#..
.#........
...#.....#
##.##.....