###...#...
#.....#...
........##
..........
#.###.#..#
#.........
..........
....#...##
.........#
..#.......