.#........
.###.....#
.....##..#
..##......
...#..#...
......#...
..........
.#...#..#.
...#....#.
.#......#.