.##.......
.......##.
#..###.#..
.......#..
.#.#......
........#.
....#...#.
....##....
..........
..##....#.