.#........
.....#....
.##..#....
..........
###...##..
....#.....
........##
.#.......#
.....#....
....###.#.