..........
...###..##
.#........
..........
..........
.###.#.#..
.......#..
..#..#....
.##.....#.
.#...#..#.