#.........
#...####..
..#.......
..#....#..
#.#.......
#......#..
.......#..
.........#
.........#
#...#.#..#