.###......
...#.....#
..........
....#.#...
..#.......
.##..#.##.
.....#..#.
.##.......
......#...
........##