##........
..........
.##......#
..........
.......###
....##....
....##...#
..........
..#..#...#
#.#..##...