..........
..#...##..
..#.#.....
#.#.##....
..........
.#...##...
..........
...#.....#
##........
##.....##.